W         C             W
WHTTTTTTTTTTTTT         W
WH             C        W
WH    G      HTTTTTTTTTTW
WH   TT      H          W
WH           H          W
WH           H          W
WH           H          W
WH           H          W
WH C         H         CW
WHTTTTTTTT  TTTTHTT  TTHW
WH              H      HW
WH              H      HW
WHC     M       H   C  HW 
XXXXXXXXXXXXXXXXXXXXXXXXX