W                       W
W                       W
W              C     H  W
W             TTTTTTTHTTW
W     H   C          H  W
W   TTHTTTTTTT       H  W
W     H              H  W
W     H              H  W
W     H              H  W
WH C  H     G        H CW
WHTTTTTTTTTTTTTTHTTTTTTHW
WH              H      HW
WH              H      HW
WHC     M       H     CHW 
XXXXXXXXXXXXXXXXXXXXXXXXX